amiskwâciwaskahikan	amiskwâciwaskahikan	+?
apsis	apsis	+?
atâwêwikamiwa	atâwêwikamiwa	+?
âpokosîs	âpokosîs	+?
cakêk	cakêk	+?
cîscaysîpwâkanis	cîscaysîpwâkanis	+?
côcô	côcô	+?
isîyihkâs	isîyihkâs	+?
itamaciho	itamaciho	+?
matahminak	matahminak	+?
mickciy	mickciy	+?
mistêhtapiwin	mistêhtapiwin	+?
mistaskipwâwa	mistaskipwâwa	+?
mistikinosêw	mistikinosêw	+?
mistimaskisina	mistimaskisina	+?
mitawakay	mitawakay	+?
nihtâ	nihtâ	+?
ninêkihikwak	ninêkihikwak	+?
nitâwasimisak	nitâwasimisak	+?
nohtê	nohtê	+?
ôhô	ôhô	+?
pê	pê	+?
pîkiskwâs	pîkiskwâs	+?
êisîyihkâsoyan	êisîyihkâsoyan	+?
wîkinân	wîkinân	+?
